F 9,25,59
EA ./xpm/E.xpm
	N ./xpm/N.xpm
C 5,5,50
	S ./xpm/S.xpm
WE ./xpm/W.xpm

      11111111111111111111111
     1011111100000001000000111111111111
     111111110100000000000001111
    11111111100000000W011111111111
  11110000000010000000000011111111
1100000100000000001100000111111111111
110000000000000101 1000011 1111
111111111111111111 1111111 1111
